  R     1000 600
   NO          ./textures/brick.xpm     


SO    ./textures/blue.xpm
WE ./textures/wood.xpm
EA ./textures/grey.xpm

S  ./textures/chest.xpm
C 225,  30,  0
F 200, 0, 0

        11111111111111111111111111111111111111
        10000000001100000000000000000000000001
        10110000011100000020000011111000000001
        1011000000000000000000001   1000000001
111111111011000001110000000000001   1111111111
100000000011000001110111111111111
1100011111111111111000000000111   11111111 111
1110111     1111111000000000111111000000W1 101
1100001  111100011100000000000000000000111 111
1000201111000001111000000000111111111011
10000000000000011110000000001       101                 111
10000001111100011111111110001111    10111111111111111111101
11111111 11101011 11000000000011    10000000000000000000001
         11111111 11111111111111    11111111111111111111111


