  R     1000 600
   NO          ./textures/brick.xpm     


SO    ./textures/blue.xpm
WE ./textures/wood.xpm
EA ./textures/grey.xpm

S  ./textures/chest.xpm
C 225,  30,  0
F 200, 0, 0

1111111
1000001
10000N1
1000001
1000001
1000001
1001001
1000001
1000001
1111111

