  R     1000 600
   NO          ./textures/brick.xpm     


SO    ./textures/blue.xpm
WE ./textures/wood.xpm
EA ./textures/grey.xpm

S  ./textures/chest.xpm
C 225,  30,  0
F 200, 0, 0

        1111111111111111111111111   1111111111
        10000000010000000000000011111000000001
        10010000010000000020000000000000000001
        10010000000000000000000011111000000001
111111111001000001000000000000001   1111111111
100000000001000001111111111111111
10000011111111111100000000001   1111111111 111111
1110111     100000000000000011111000000001 100001
1000001     10000N000000000000000000000001 100001
100020111111100000000000000011111111101111 111111
10000000000000000000000000001       101                 111
10000001111100111111111110001111    10111111111111111111101
11111111 10000001 11000000000011    10000000000000000000001
         10000001 11111111111111    11111111111111111111111
         11111111  

