R  1920  1080     
   
   NO          ./textures/brick.xpm     
SO    ./textures/blue.xpm
WE ./textures/wood.xpm
EA ./textures/grey.xpm
S ./textures/chest.xpm
F    220,  100, 0
C 225,  30,  0





        1111111111111111111111111
        1000000000110000000000001
        1011000001110000002000001
        1001000000000000000000001
111111111011000001110000000000001
100000000011000001110111111111111
1111011111111101110000001000111    11111111
11101111111110111010100100000111111000000N1
1100000011010101110000001000000000000001111
1000200000000001100000010000111111111111
10000000000000001101010010001
1100000111010101111101111000111
11110111 11101011 10111101000011
11111111 11111111 111111111111


