  R    1000 600
   NO          ./textures/brick.xpm     


SO    ./textures/blue.xpm
WE ./textures/wood.xpm
EA ./textures/grey.xpm

S  ./textures/chest.xpm
C 225,  30,  0
F 200, 0, 0

11111111111111111111111111111111
10000010000000000000000000000001
10000N10000011111111010101010101
10000000000000000000000000000001
10000010000011111111010101010101
10000010000000000000000000000001
11101110000011111111010101010101
11101111101111111111000000000001
10000000000000000000000000000001
11111111111111111111111111111111

