  R     1920 1080
   NO          ./textures/brick.xpm     


SO    ./textures/blue.xpm
WE ./textures/wood.xpm
EA ./textures/grey.xpm

S  ./textures/chest.xpm
C 225,  30,  0
F 255, 100, 1

        11111111111111111111111111111111111111
        10000000000110000000000000000000000001
        10110000011100000020000011111000000001
        1001000000000000000000001   1000000001
111111111011000001110000000000001   1111111111
100000000011000001110111111111111
1111011111111101110000001000111   11111111 111
1110111     1011101010000000111111000000W1 101
1100001  111101011100000010000000000000111 111
1000201111000001100000010000111111111011
10000000000000001101010010001       101                 111
1100000111010101111101111000111     10111111111111111111101
11111111 11101011 10111101000011    10000000000000000000001
         11111111 111111111111      11111111111111111111111


