

   NO         ./textures/brick.xpm     

  R   1920 1080 
  SO   ./textures/blue.xpm
WE ./textures/wood.xpm
EA ./textures/grey.xpm
C 140, 211, 255

S  ./textures/barrel.xpm

F 44, 44, 44

 
 111111111111111111 
 10000000000000000111111111111111  
 11111111111111110000000000000001  
                10111111111111101  
 111111111111111101           101  
 100000000000000001           101
 111111111111111111           101
                              101
 1111111111111111111111111111 101 
 1000000000000000000000000001 101    
 1011111111111111111111111101 101 
 101                1111  101 101 
 101   11111111111111101111011101 
 101   100000000200000W0000000001 
 101   10111111111111111111011101
 101   101                101 101 
 101   1011111111111111111101 101  
 101   1000000000000000000001 101     
 101   1111111111111111111111 101    
 101                          101   
 10111111111111111111111111111101     
 10000000000000000000000000000001 
 11111111111111111111111111111111 
